        NO       ./textures/eagle2.xpm            
   SO   ./textures/brick.xpm
      WE       ./textures/wall_1.xpm
          EA         ./textures/wall_2.xpm

    

         F 43   ,  96   ,   112   
     C   36,   101   ,  242        

    11111     11111 
    10001     100111
  1110011111111000011
  1111000100000030011111
111000004444440000000001
100000000000000100011121
10000000000000000011 101
100300000N0000000001 101
10000001000000000001 101
10030011111111100001 101
1000001    1000000011121
100300111111000000000001
110000000020000000011111
10000011111111111121
1011111    100000001
1000001    121111111
1100041    100000001
1111111    111111111



