111111111111111111111111111111111
100000000011000000000000000000001
1011000001110000000N0000000000001
100100000000000000000000000000001
111111111011000001110000000000001
100000000011000001110111111111111
111101111111110111000000100000001
111101111111110111010100100000001
110000001101010111000000100000001
100000000000000011000000000000001
100000000000000011010100100000001
110000011101010111111111100000111
111101111111010111111111100000001
111111111111111111111111111111111