111111111111111111111111
100000000000000000000001
100000000000000000000001
100000000000000000000001
100000000000000000000001
100000000000000000000001
100011101110000000000001
100010000010000000000001
100011111110000000000001
100000000000000000000001
100000000000000000000001
100000000000000000000001
111111111111111111111111