NO textures/greenlight.xpm
SO textures/pillar.xpm
WE textures/barrel.xpm
EA textures/eagle.xpm


1111111111111111111111
1000000000000000000001
100000000E000000000001
1000000000000000000001
1111111111111111111111
F    220,100,0
C    225,30,0
