NO              src/textures/eagle.xpm 

SO src/textures/greenlight.xpm
WE src/textures/pillar.xpm
EA src/textures/barrel.xpm
F    255,255,255 
C 0,0,0
111111111
1000000001111111111111
1000000110000000000001
100S00010000001111111
1000000100000000000001
1101011100000000000001
1000000000000000000001
1000000000000000000001
1000000000000000000001
1100000000000000000001
1111111111111111111111
