NO src/textures/eagle.xpm
SO src/textures/eagle.xpm
WE src/textures/eagle.xpm
EA src/textures/eagle.xpm

F    220,100,0
C    225,30,0

1111111
1E1
11111111
