NO src/textures/eagle.xpm
SO src/textures/eagle.xpm
WE src/textures/eagle.xpm
EA src/textures/eagle.xpm
C 255,255,255
F 0,0,0












1111111111111111111111111111111111111111111111
100000000000000000001           10000001
1000000001000000000001          1N000001
1000000000000000000001        1111111111
11111111111111111111111        
