NO textures/greenlight.xpm
SO textures/pillar.xpm
WE textures/barrel.xpm
EA textures/eagle.xpm

F    220,100,255
C    225,30,0

111111
100001
100N01
10001
11111
