NO textures/greenlight.xpm
SO textures/pillar.xpm
WE textures/barrel.xpm
EA textures/eagle.xpm
F    220,100,0
C    225,30,0




1111111111111111111111
