       NO ./pics/eagle.png 
    SO ./pics/bluestone.png
WE ./pics/mossy.png
     EA ./pics/greystone.png




         F 56,255,39
     C   0,   198,    220

    11111  111111
    10001  100101
  111001111100001
  111110010000001
11100000000000001
10000000000010001
1000000P000000001
10000000000000001
10000001000000001
10000011111100001
1000001    100001
1000001    100001
1100101    111001
1000001    100001
1011111    100001
1000001    100001
1100001    100001
1111111    111111



