        NO       ./textures/eagle.xpm            
   SO   ./textures/brick.xpm
      WE       ./textures/wall_1.xpm
          EA         ./textures/wall_2.xpm

    

         F 43   ,  96   ,   112   
     C   36,   101   ,  242        

    11111  11111 
    10001  1001 1
  111001111100011
  111110010000001
11100000000000001
10000000000010001  
10000000000000011
100000000N0000001
10000001000000001
10000011111100000
1000001    100001
1000001    100001
1100101    111001
1000001 1  100001
1011111    100001
1000001    100001
1100001    100001
1111111    111111
